15 15 15 15 15 15 15 15 15 15 15 15 15 15 15 15 15 15 15 15 15 15 15 15 15 15 15 15 15 15 15 15 15 15 15 15 15 15 15 15 15 15 15 15 15 15 15 15 15 15
15 10 11 11 10 10 11 11 10 10 11 11 10 10 11 11 10 10 11 11 11 11 10 10 10 11 11 10 10 10 11 11 10 11 10 11 10 10 11 11 11 10 11 10 10 11 10 11 10 15
15 10 11 11 10 10 11 11 10 10 11 11 10 10 11 11 10 10 11 11 11 11 10 10 10 11 11 10 10 10 11 11 10 11 10 11 10 10 11 11 11 10 11 10 10 11 10 11 10 15
15 10 11 11 10 10 11 11 10 10 11 11 10 10 11 11 10 10 11 11 11 11 10 10 10 11 11 10 10 10 11 11 10 11 10 11 10 10 11 11 11 10 11 10 10 11 10 11 10 15
15 10 11 11 10 10 11 11 10 10 11 11 10 10 11 11 10 10 11 11 11 11 10 10 10 11 11 10 10 10 11 11 10 11 10 11 10 10 11 11 11 10 11 10 10 11 10 11 10 15
15 10 11 11 14 14 14 14 10 10 13 13 13 13 13 11 10 10 11 11 11 11 10 10 10 11 11 10 10 10 11 11 10 11 10 11 10 10 11 11 11 10 11 10 10 11 10 11 10 15
15 10 11 11 14 14 14 14 10 10 13 13 13 13 13 11 10 10 11 11 11 11 10 10 10 11 11 10 10 10 11 11 10 11 10 11 10 10 11 11 11 10 11 10 10 11 10 11 10 15
15 10 11 11 14 14 14 14 10 10 13 13 13 13 13 11 10 10 11 11 11 11 10 10 10 11 11 10 10 10 11 11 10 11 10 11 10 10 11 11 11 10 11 10 10 11 10 11 10 15
15 10 11 11 10 10 11 11 10 10 13 13 13 13 13 11 10 10 11 11 11 11 10 10 10 11 11 10 10 10 11 11 10 11 10 11 10 10 11 11 11 10 11 10 10 11 10 11 10 15
15 10 11 11 10 10 11 11 10 10 11 11 12 12 12 12 12 11 11 11 10 10 10 11 11 10 10 10 11 11 10 11 10 11 10 10 11 11 11 10 11 10 10 11 10 11 10 10 10 15
15 10 11 11 10 10 11 11 10 10 11 11 12 12 12 12 12 11 11 11 11 10 10 10 11 11 10 10 10 11 11 10 11 10 11 10 10 11 11 11 10 11 10 10 11 10 11 10 11 15
15 10 11 11 10 10 11 11 10 10 11 11 10 10 11 11 10 10 11 11 11 11 10 10 10 11 11 10 10 10 11 11 10 11 10 11 10 10 11 11 11 10 11 10 10 11 10 11 10 15
15 10 11 11 10 10 11 11 10 10 11 11 10 10 11 11 10 10 11 11 11 11 10 10 10 11 11 10 10 10 11 11 10 11 10 11 10 10 11 11 11 10 11 10 10 11 10 11 10 15
15 10 11 11 10 10 11 11 10 10 11 11 10 10 11 11 10 10 11 11 11 11 10 10 10 11 11 10 10 10 11 11 10 11 10 11 10 10 11 11 11 10 11 10 10 11 10 11 10 15
15 10 11 11 10 10 11 11 10 10 11 11 10 10 11 11 10 10 11 11 11 11 10 10 10 11 11 10 10 10 11 11 10 11 10 11 10 10 11 11 11 10 11 10 10 11 10 11 10 15
15 10 11 11 10 10 11 11 10 10 11 11 10 10 11 11 10 10 11 11 11 11 10 10 10 11 11 10 10 10 11 11 10 11 10 11 10 10 11 11 11 10 11 10 10 11 10 11 10 15
15 10 11 11 10 10 11 11 10 10 11 11 10 10 11 11 10 10 11 11 11 11 10 10 10 11 11 10 10 10 11 11 10 11 10 11 10 10 11 11 11 10 11 10 10 11 10 11 10 15
15 10 11 11 10 10 11 11 10 10 11 11 10 10 11 11 10 10 11 11 11 11 10 10 10 11 11 10 10 10 11 11 10 11 10 11 10 10 11 11 11 10 11 10 10 11 10 11 10 15
15 10 11 11 10 10 11 11 10 10 11 14 14 14 14 11 10 10 11 11 11 11 10 10 10 11 11 10 10 10 11 11 10 11 10 11 10 10 11 11 11 10 11 10 10 11 10 11 10 15
15 10 11 11 10 10 11 11 10 10 11 14 14 14 14 11 10 10 11 11 11 11 10 10 10 11 11 10 10 10 11 11 10 11 10 11 10 10 11 11 11 10 11 10 10 11 10 11 10 15
15 10 11 11 10 10 11 11 10 10 11 11 10 10 11 11 10 10 11 11 11 11 10 10 10 11 11 10 10 10 11 11 10 11 10 11 10 10 11 11 11 10 11 10 10 11 10 11 10 15
15 10 11 11 10 10 11 11 10 10 11 11 10 10 11 11 10 10 11 11 11 11 11 10 11 11 11 10 10 10 11 11 10 11 10 11 10 10 11 11 11 10 11 10 10 11 10 11 10 15
15 10 11 11 10 10 11 11 10 10 11 11 10 10 11 11 10 10 11 11 11 11 11 10 10 11 11 10 10 10 11 11 10 11 10 11 10 10 11 11 11 10 11 10 10 11 10 11 10 15
15 10 11 11 10 10 11 11 10 10 11 11 10 10 11 11 10 10 11 11 11 12 12 12 12 12 11 10 10 10 11 11 10 11 10 11 10 10 11 11 11 10 11 10 10 11 10 11 10 15
15 10 11 11 10 10 11 11 10 10 11 11 10 10 11 11 10 10 11 11 11 12 12 12 12 12 11 10 10 10 11 11 10 11 10 11 10 10 11 11 11 10 11 10 10 11 10 11 10 15
15 10 11 11 10 10 11 11 10 10 11 11 10 10 11 11 10 10 11 11 11 12 12 12 12 12 11 10 10 10 11 11 10 11 10 11 10 10 11 11 11 10 11 10 10 11 10 11 10 15
15 10 11 11 10 10 11 11 10 10 11 11 10 10 11 11 10 10 11 11 11 11 10 10 10 11 11 10 10 10 11 11 10 11 10 11 10 10 11 11 11 10 11 10 10 11 10 11 10 15
15 10 11 11 10 10 11 11 10 10 11 11 10 10 11 11 10 10 11 11 11 11 10 10 10 11 11 10 10 10 11 11 10 11 10 11 10 10 11 11 11 10 11 10 10 11 10 11 10 15
15 10 11 11 10 10 11 11 10 10 11 11 10 10 11 11 10 10 11 11 11 11 10 10 10 11 11 10 10 10 11 11 10 11 10 11 10 10 11 11 11 10 11 10 10 11 10 11 10 15
15 10 11 11 10 10 11 11 10 10 11 11 10 10 11 11 10 10 11 11 11 11 10 10 10 11 11 10 10 10 11 11 10 11 10 11 10 10 11 11 11 10 11 10 10 11 10 11 10 15
15 10 11 11 10 10 11 11 10 10 11 11 10 10 11 11 10 10 11 11 11 11 10 10 10 11 11 10 10 10 11 11 10 11 10 11 10 10 11 11 11 10 11 10 10 11 10 11 10 15
15 10 11 11 10 10 11 11 10 10 11 11 10 10 11 11 10 10 11 11 11 11 10 10 10 11 11 10 10 10 11 11 10 11 10 11 10 10 11 11 11 10 11 10 10 11 10 11 10 15
15 10 11 11 10 10 11 11 10 10 11 11 10 10 11 11 10 10 11 11 11 11 10 10 10 11 11 10 10 10 11 11 10 11 10 11 10 10 11 11 11 10 11 10 10 11 10 11 10 15
15 10 11 11 10 10 11 11 10 10 11 11 10 10 11 11 10 10 11 11 11 11 10 10 10 11 11 10 10 10 11 11 10 11 10 11 10 10 11 11 11 10 11 10 10 11 10 11 10 15
15 10 11 11 10 10 11 11 10 10 11 11 10 10 11 11 10 10 11 11 11 11 10 10 10 11 11 10 10 10 11 11 10 11 10 11 10 10 11 11 11 10 11 10 10 11 10 11 10 15
15 10 11 11 10 10 11 11 10 10 11 11 10 10 11 11 10 10 11 11 11 11 10 10 10 11 11 10 10 10 11 11 10 11 10 11 10 10 11 11 11 10 11 10 10 11 10 11 10 15
15 10 11 11 10 10 11 11 10 10 11 11 10 10 11 11 10 10 11 11 11 11 10 10 10 11 11 10 10 10 11 11 10 11 10 11 10 10 11 11 11 10 11 10 10 11 10 11 10 15
15 10 11 11 10 10 11 11 10 10 11 11 10 10 11 11 10 10 11 11 11 11 10 10 10 11 11 10 10 10 11 11 10 11 10 11 10 10 11 11 11 10 11 10 10 11 10 11 10 15
15 10 11 11 10 10 11 11 10 10 11 11 10 10 11 11 10 10 11 11 11 11 10 10 10 11 11 10 10 10 11 11 10 11 10 11 10 10 11 11 11 10 11 10 10 11 10 11 10 15
15 10 11 11 10 10 11 11 10 10 11 11 10 10 11 11 10 10 11 11 11 11 10 10 10 11 11 10 10 10 11 11 10 11 10 11 10 10 11 11 11 10 11 10 10 11 10 11 10 15
15 10 11 11 10 10 11 11 10 10 11 11 10 10 11 11 10 10 11 11 11 11 10 10 10 11 11 10 10 10 11 11 10 11 10 11 10 10 11 11 11 10 11 10 10 11 10 11 10 15
15 10 11 11 10 10 11 11 10 10 11 11 10 10 11 11 10 10 11 11 11 11 10 10 10 11 11 10 10 10 11 11 10 11 10 11 10 10 11 11 11 10 11 10 10 11 10 11 10 15
15 10 11 11 10 10 11 11 10 10 11 11 10 10 11 11 10 10 11 11 11 11 10 10 10 11 11 10 10 10 11 11 10 11 10 11 10 10 11 11 11 10 11 10 10 11 10 11 10 15
15 10 11 11 10 10 11 11 10 10 11 11 10 10 11 11 10 10 11 11 11 11 10 10 10 11 11 10 10 10 11 11 10 11 10 11 10 10 11 11 11 10 11 10 10 11 10 11 10 15
15 10 11 11 10 10 11 11 10 10 11 11 10 10 11 11 10 10 11 11 11 11 10 10 10 11 11 10 10 10 11 11 10 11 10 11 10 10 11 11 11 10 11 10 10 11 10 11 10 15
15 10 11 11 10 10 11 11 10 10 11 11 10 10 11 11 10 10 11 11 11 11 10 10 10 11 11 10 10 10 11 11 10 11 10 11 10 10 11 11 11 10 11 10 10 11 10 11 10 15
15 10 11 11 10 10 11 11 10 10 11 11 10 10 11 11 10 10 11 11 11 11 10 10 10 11 11 10 10 10 11 11 10 11 10 11 10 10 11 11 11 10 11 10 10 11 10 11 10 15
15 10 11 11 10 10 11 11 10 10 11 11 10 10 11 11 10 10 11 11 11 11 10 10 10 11 11 10 10 10 11 11 10 11 10 11 10 10 11 11 11 10 11 10 10 11 10 11 10 15
15 10 11 11 10 10 11 11 10 10 11 11 10 10 11 11 10 10 11 11 11 11 10 10 10 11 11 10 10 10 11 11 10 11 10 11 10 10 11 11 11 10 11 10 10 11 10 11 10 15
15 15 15 15 15 15 15 15 15 15 15 15 15 15 15 15 15 15 15 15 15 15 15 15 15 15 15 15 15 15 15 15 15 15 15 15 15 15 15 15 15 15 15 15 15 15 15 15 15 15